NO textures/hieroglyph_stone.xpm
SO textures/gold.xpm
WE textures/sandstone2.xpm
EA textures/sandstone3.xpm
DO textures/door2.xpm

C 38,33,18
F 74,59,12

        1111111111111111111111111
        10000000001100000000000T1
        101100M001110000000000001
        1001000000000000000000001
111111111011000001110000000000001
100000000011C000011101D111D111111
1111D111111111011100000010001
11110111111111011101010000001
11000000110101011100000000M01
1M000000C00000001100000010001
10000000000000001101010010001
11000001110101011111T11110N0111
11110111 1110101 101111010001
11111111 1111111 111111111111